T  d   T   d  T
 D   t   t   D 
  D   d d   D  
d  D   d   D  d
    D     D    
 t   t   t   t 
  d   d d   d  
T  d   *   d  T
  d   d d   d  
 t   t   t   t 
    D     D    
d  D   d   D  d
  D   d d   D  
 D   t   t   D 
T  d   T   d  T